4
4
7
0
3,3,3,3,3,3,0,0,0,0,8,0,0,0,0,0,7,7,7,7
3,3,3,3,3,3,0,0,0,0,8,0,0,0,0,0,7,7,7,7
0,0,0,0,0,0,0,0,0,0,8,0,0,0,0,0,7,7,7,7
0,0,0,0,0,0,0,0,0,0,8,0,0,0,0,0,7,7,7,7
2,2,0,0,0,0,0,12,0,0,8,0,0,0,0,0,7,7,7,7
2,2,0,0,0,0,0,0,0,0,8,0,0,0,11,0,0,0,0,0
2,2,0,0,0,0,0,0,0,0,8,4,4,4,0,0,0,0,0,0
2,2,0,0,0,0,0,0,0,0,8,4,4,4,0,0,0,0,0,0
2,2,0,0,0,0,0,0,0,0,8,4,4,4,0,0,0,0,0,0
9,9,9,9,9,9,9,9,9,9,9,9,9,9,9,9,9,9,9,9
0,0,0,0,0,0,0,0,0,0,8,0,0,0,0,0,0,0,0,0
0,0,0,0,0,0,0,0,0,0,8,0,0,0,0,0,0,0,2,2
2,2,0,0,0,0,0,0,0,0,8,0,0,0,0,0,11,0,2,2
2,2,0,0,0,0,0,0,0,0,8,0,0,0,0,0,0,0,2,2
2,2,0,0,0,0,0,0,0,0,8,0,0,0,0,0,0,0,2,2
2,2,0,0,0,0,0,0,0,0,8,0,0,0,0,0,0,0,2,2
2,2,0,0,0,11,0,0,0,0,8,0,0,0,0,0,0,0,2,2
0,0,0,0,0,0,0,0,0,0,8,0,0,0,0,0,0,0,0,0
3,3,3,3,3,3,3,3,0,0,8,0,0,0,3,3,3,3,3,3
3,3,3,3,3,3,3,3,0,0,8,0,0,0,3,3,3,3,3,3
