4
3
7
0
0,0,0,0,0,0,0,0,0,0,0,0,0,0,0,0,0,0,0,0
0,0,0,0,0,0,0,0,0,0,0,0,0,0,0,0,0,0,0,0
0,0,2,2,2,2,0,0,0,0,0,0,2,2,2,2,2,2,0,0
0,0,2,0,0,0,0,0,0,0,0,0,0,0,0,0,0,2,0,0
0,0,2,0,0,0,0,0,0,0,0,0,0,0,0,0,0,2,0,0
0,0,2,0,0,0,0,0,0,0,0,0,0,0,11,0,0,2,0,0
0,0,2,0,0,2,2,2,0,0,0,2,2,2,2,0,0,2,0,0
0,0,0,0,0,2,0,0,0,0,0,0,0,0,2,0,0,0,0,0
0,0,0,0,0,2,0,0,5,5,5,5,0,0,2,0,0,0,0,0
0,0,0,0,0,0,0,0,5,5,5,5,0,0,0,0,0,0,0,0
0,0,12,0,0,0,0,0,5,5,5,5,0,0,0,0,0,0,0,0
0,0,0,0,0,0,0,0,5,5,5,5,0,0,0,0,0,0,0,0
0,0,0,0,0,2,0,0,0,0,0,0,0,0,2,0,11,2,0,0
0,0,2,0,0,2,0,0,0,0,0,0,0,0,2,0,0,2,0,0
0,0,2,0,0,2,2,2,0,0,0,2,2,2,2,0,0,2,0,0
0,0,2,0,0,0,0,0,0,0,0,0,0,0,0,0,0,2,0,0
0,0,2,0,0,11,0,0,0,0,0,0,0,0,0,0,0,2,0,0
0,0,2,2,2,2,0,0,0,0,0,0,2,2,2,2,2,2,0,0
0,0,0,0,0,0,0,0,0,0,0,0,0,0,0,0,0,0,0,0
0,0,0,0,0,0,0,0,0,0,0,0,0,0,0,0,0,0,0,0
